SO textures/wall_south.xpm
WE textures/wall_west.xpm
NO textures/wall_north.xpm
EA textures/wall_east.xpm

C 30,15,15
F 50,10,10

111111111111
100000000001
100000000001
100000000001
100000000001
100000000001
10000N000001
100000000001
100000000001
111111111111